: inscne
ab	ban-ab
adhaltrach	banadhaltrach
aisteoir	ban-aisteoir
altra	banaltra
ardmháistir	ardmháistreás
athair	máthair
bainisteoir	bainistreás
bíocunta	bíocuntaois
bráthair	siúr
buachaill	cailín
cara	banchara
cealgaire	banchealgaire
cliamhain	banchliamhain
cunta	cuntaois
daideo	mamó
daidí	mamaí
dea-fhear	dea-bhean
deartháir	deirfiúr
dia	bandia
diúc	bandiúc
dochtúir	bandochtúir
doirseoir	bandoirseoir
draoi	bandraoi
é	í
fáidh	banfháidh
file	banfhile
flaith	banfhlaith
freastalaí	banfhreastalaí
fuirseoir	banfhuirseoir
gaiscíoch	banghaiscíoch
garda	bangharda
garmhac	gariníon
garnia	garneacht
impire	banimpire
laoch	banlaoch
leasathair	leasmháthair
leasdeartháir	leasdeirfiúr
leasmhac	leasiníon
leon	banleon
lia	banlia
mac	iníon
máistir	máistreás
maor	banmhaor
méara	banmhéara
naomh	ban-naomh
nia	neacht
ógfhear	ógbhean
óglach	banóglach
oide	banoide
oidhre	banoidhre
óstach	banóstach
príomhaisteoir	príomh-bhanaisteoir
prionsa	banphrionsa
príosúnach	banphríosúnach
rinceoir	banrinceoir
rí	banríon
sabhdán	bansabhdán
sagart	bansagart
sé	sí
seanathair	seanmháthair
seanbhuachaill	seanchailín
seanfhear	seanbhean
seirbhíseach	banseirbhíseach
sióg	bansióg
stiúrthóir	banstiúrthóir
tiarna	bantiarna
tréadaí	bantréadaí
uchtmhac	uchtiníon
uncail	aintín
: treoracha
sall	anall
siar	aniar
síos	aníos
soir	anoir
suas	anuas
: sona-dona
saibhir	daibhir
saoi	daoi
saoirse	daoirse
saor	daor
sochar	dochar
sochma	dochma
soilbhir	doilbhir
soiléir	doiléir
soilíos	doilíos
soineann	doineann
soineanta	doineanta
sólás	dólás
sona	dona
sonas	donas
sorcha	dorcha
suáilce	duáilce
suairc	duairc
: ceoltóirí-gléasanna-ceoil
basún	basúnadóir
bodhrán	bodhránaí
cairdín	cairdíneoir
clairinéad	clairinéadóir
cláirseach	cláirseoir
cruit	cruitire
dord	dordóir
dordghiotár	dordghiotáraí
dordveidhil	dordveidhleadóir
druma	drumadóir
fidil	fidléir
fliúit	fliúiteadóir
giotár	giotáraí
óbó	óbóir
orgán	orgánaí
pianó	pianódóir
sacsafón	sacsafónaí
tiompán	tiompánaí
tiúba	tiúbadóir
trombón	trombónaí
trumpa	trumpadóir
veidhlín	veidhleadóir
xileafón	xileafónaí
: aidiacht-neamhchosúil
áitiúil	domhanda
annamh	minic
ard	íseal
bán	dubh
beag	mór
beo	marbh
ceart	mícheart
cinnte	neamhchinnte
cúng	leathan
deacair	éasca
domhanda	áitiúil
dubh	bán
dúnta	oscailte
éasca	deacair
fada	gearr
gearr	fada
íseal	ard
lag	láidir
láidir	lag
leathan	cúng
marbh	beo
mícheart	ceart
minic	annamh
míshásta	sásta
mór	beag
neamhchinnte	cinnte
neamhoifigiúil	oifigiúil
nua	sean
oifigiúil	neamhoifigiúil
oscailte	dúnta
poiblí	príobháideach
príobháideach	poiblí
sásta	míshásta
sean	nua
: aidiacht-breischéim
ard	airde
beag	lú
ceart	cirte
cruinn	cruinne
cuimsitheach	cuimsithí
deacair	deacra
déanach	déanaí
deas	deise
deireanach	deireanaí
dian	déine
dlúth	dlúithe
domhain	doimhne
éifeachtach	éifeachtaí
fada	faide
forleathan	forleithne
gar	gaire
géar	géire
gearr	giorra
iomlán	iomláine
íseal	ísle
láidir	láidre
leathan	leithne
luath	luaithe
maith	fearr
mall	moille
minic	minice
mór	mó
óg	óige
oiriúnach	oiriúnaí
olc	measa
saor	saoire
sean	sine
soiléir	soiléire
tábhachtach	tábhachtaí
: ainmfhocal-ginideach
acht	achta
airgeadas	airgeadais
airgead	airgid
aonar	aonair
bainistíocht	bainistíochta
bliain	bliana
cáin	cánach
caint	cainte
cathair	cathrach
ceannas	ceannais
ceol	ceoil
cúirt	cúirte
deireadh	deiridh
eolas	eolais
faisnéis	faisnéise
feidhm	feidhme
foghlaim	foghlama
fómhar	fómhair
fostaíocht	fostaíochta
imeacht	imeachta
iompar	iompair
ioncam	ioncaim
lá	lae
léann	léinn
leas	leasa
obair	oibre
oideachas	oideachais
oidhreacht	oidhreachta
pleanáil	pleanála
rang	ranga
roinn	roinne
scoil	scoile
seachtain	seachtaine
seirbhís	seirbhíse
tacaíocht	tacaíochta
talamh	talún
teilifís	teilifíse
tír	tíre
tuath	tuaithe
: ainmfhocal-iolra
acmhainn	acmhainní
ball	baill
bean	mná
bliain	blianta
ceann	cinn
ceart	cearta
ceist	ceisteanna
comhlacht	comhlachtaí
críoch	críocha
cúrsa	cúrsaí
dalta	daltaí
deis	deiseanna
duine	daoine
fadhb	fadhbanna
fear	fir
focal	focail
foireann	foirne
iarratas	iarratais
imeacht	imeachtaí
lá	laethanta
leabhar	leabhair
leanbh	leanaí
meán	meáin
moladh	moltaí
múinteoir	múinteoirí
páiste	páistí
rang	ranganna
riachtanas	riachtanais
riail	rialacha
rialachán	rialacháin
rialtas	rialtais
rud	rudaí
scéal	scéalta
scéim	scéimeanna
scil	scileanna
scoil	scoileanna
scoláire	scoláirí
seirbhís	seirbhísí
sonra	sonraí
stát	stáit
toradh	torthaí
tuismitheoir	tuismitheoirí
: briathar-fáistineach
abair	déarfaidh
bain	bainfidh
bí	beidh
cabhraigh	cabhróidh
caith	caithfidh
ceap	ceapfaidh
cinn	cinnfidh
cinntigh	cinnteoidh
coimeád	coimeádfaidh
coinnigh	coinneoidh
cuidigh	cuideoidh
cuir	cuirfidh
déan	déanfaidh
dírigh	díreoidh
éirigh	éireoidh
eisigh	eiseoidh
fág	fágfaidh
fan	fanfaidh
féach	féachfaidh
féad	féadfaidh
feic	feicfidh
glac	glacfaidh
gníomhaigh	gníomhóidh
iarr	iarrfaidh
inis	inseoidh
íoc	íocfaidh
labhair	labhróidh
leag	leagfaidh
lean	leanfaidh
léigh	léifidh
léirigh	léireoidh
lig	ligfidh
mair	mairfidh
oibrigh	oibreoidh
ordaigh	ordóidh
téigh	rachaidh
roghnaigh	roghnóidh
scoir	scoirfidh
seas	seasfaidh
seol	seolfaidh
socraigh	socróidh
soláthair	soláthróidh
spreag	spreagfaidh
tabhair	tabharfaidh
tacaigh	tacóidh
tar	tiocfaidh
tóg	tógfaidh
tosaigh	tosóidh
tuig	tuigfidh
úsáid	úsáidfidh
: briathar-láithreach
abair	deir
aithin	aithníonn
athraigh	athraíonn
bain	baineann
bí	bíonn
braith	braitheann
cabhraigh	cabhraíonn
caith	caitheann
ciallaigh	ciallaíonn
creid	creideann
cuimsigh	cuimsíonn
cuir	cuireann
cum	cumann
déan	déanann
eascair	eascraíonn
éiligh	éilíonn
éirigh	éiríonn
fág	fágann
faigh	faigheann
folaigh	folaíonn
glac	glacann
iarr	iarrann
íoc	íocann
labhair	labhraíonn
leag	leagann
lean	leanann
léirigh	léiríonn
léigh	léann
lig	ligeann
luaigh	luann
mair	maireann
meas	measann
mol	molann
oibrigh	oibríonn
oir	oireann
rith	ritheann
roghnaigh	roghnaíonn
scríobh	scríobhann
seas	seasann
soláthair	soláthraíonn
spreag	spreagann
tacaigh	tacaíonn
tar	tagann
taispeáin	taispeánann
tarlaigh	tarlaíonn
teastaigh	teastaíonn
téigh	téann
tosaigh	tosaíonn
tabhair	tugann
tuig	tuigeann
úsáid	úsáideann
: forainm-1u
ag	agam
ar	orm
as	asam
de	díom
do	dom
faoi	fúm
i	ionam
le	liom
ó	uaim
roimh	romham
trí	tríom
um	umam
: forainm-2u
ag	agat
ar	ort
as	asat
de	díot
do	duit
faoi	fút
i	ionat
le	leat
ó	uait
roimh	romhat
trí	tríot
um	umat
: forainm-3u-bain
ag	aici
ar	uirthi
as	aisti
de	di
do	di
faoi	fúithi
i	inti
le	léi
ó	uaithi
roimh	roimpi
trí	tríthi
um	uimpi
: forainm-1i
ag	againn
ar	orainn
as	asainn
de	dínn
do	dúinn
faoi	fúinn
i	ionainn
idir	eadrainn
le	linn
ó	uainn
roimh	romhainn
trí	trínn
um	umainn
: forainm-2i
ag	agaibh
ar	oraibh
as	asaibh
de	díbh
do	daoibh
faoi	fúibh
i	ionaibh
idir	eadraibh
le	libh
ó	uaibh
roimh	romhaibh
trí	tríbh
um	umaibh
: forainm-3i
ag	acu
ar	orthu
as	astu
de	díobh
do	dóibh
faoi	fúthu
i	iontu
idir	eatarthu
le	leo
ó	uathu
roimh	rompu
trí	tríothu
um	umpu
